+--+**+--+**+ 
| *         |
+  +--+--+--+ 
|  |     |  | 
+  +  +  +  + 
|     |     g 
+--+**+--+**+
